PLAYER_ID,SEASON_ID,LEAGUE_ID,TEAM_ID,TEAM_ABBREVIATION,PLAYER_AGE,GP,GS,MIN,FGM,FGA,FG_PCT,FG3M,FG3A,FG3_PCT,FTM,FTA,FT_PCT,OREB,DREB,REB,AST,STL,BLK,TOV,PF,PTS,FG2M,FG2A,FG2_PCT
1627783,2016-17,00,1610612761,TOR,23.0,55,38,859.0,103,205,0.502,1,7,0.143,22,32,0.688,64,121,185,17,26,45,33,109,229,102,198,0.515
1627783,2017-18,00,1610612761,TOR,24.0,81,5,1679.0,253,498,0.508,29,132,0.22,54,87,0.621,79,285,364,159,62,42,67,166,589,224,366,0.612
1627783,2018-19,00,1610612761,TOR,25.0,80,79,2548.0,519,945,0.549,79,214,0.369,237,302,0.785,124,425,549,248,73,52,154,241,1354,440,731,0.602
1627783,2019-20,00,1610612761,TOR,26.0,60,60,2110.0,500,1104,0.453,131,365,0.359,240,303,0.792,64,375,439,207,61,53,148,170,1371,369,739,0.499
1627783,2020-21,00,1610612761,TOR,27.0,56,56,2006.0,437,961,0.455,73,246,0.297,249,301,0.827,95,310,405,250,64,37,130,174,1196,364,715,0.509
1627783,2021-22,00,1610612761,TOR,28.0,68,68,2578.0,596,1207,0.494,75,218,0.344,284,379,0.749,128,452,580,360,85,42,181,225,1551,521,989,0.527
1627783,2022-23,00,1610612761,TOR,29.0,71,71,2652.0,630,1313,0.48,93,287,0.324,367,474,0.774,131,425,556,415,65,36,169,228,1720,537,1026,0.523
1627783,2023-24,00,1610612761,TOR,29.0,39,39,1354.0,325,623,0.522,46,145,0.317,169,223,0.758,54,192,246,190,32,10,83,87,865,279,478,0.584
1627783,2023-24,00,1610612754,IND,29.0,24,24,786.0,203,370,0.549,28,73,0.384,60,86,0.698,46,122,168,102,17,8,34,62,494,175,297,0.589
1627783,2023-24,00,0,TOT,29.0,63,63,2140.0,528,993,0.532,74,218,0.339,229,309,0.741,100,314,414,292,49,18,117,149,1359,454,775,0.586
